10 10
W	W	W	0	0	0	0	0	0	0
T	0	W	0	0	0	0	0	0	0
0	W	W	0	M	0	0	M	0	0
0	0	W	0	0	0	0	0	0	0
W	0	W	0	0	0	0	0	0	0
0	0	W	0	0	0	0	0	0	0
0	W	W	M	0	0	0	0	0	0
0	0	0	0	0	W	0	0	P	0
0	0	0	0	0	0	0	0	0	0
0	0	M	0	0	0	0	0	0	0